111111111111111
1P011C00C1000E1
100011100111001
1C000000000C001
111111111111111
