111111111111111111111111
1P111C0000111000110100C1
101000011000000100000E01
1C1000000C01110C00000001
101011111000000000110001
10000C000000C100011000C1
111111111111111111111111
